10,10,10,10,10,10,10,10,10,08,00,00,00,25,26,27,28,00,00,00,08,10,10,10,10,10,10,10,10,10,10,10
10,10,10,10,10,10,10,10,10,09,08,08,00,32,29,30,31,00,08,08,08,10,10,10,10,10,10,10,10,10,10,10
10,10,10,10,10,10,10,10,09,09,09,09,08,08,33,34,08,08,09,09,09,09,10,10,10,10,10,10,10,10,10,10
10,10,10,10,10,10,10,10,12,12,12,12,12,12,19,22,12,12,12,12,12,12,12,10,10,10,10,10,10,10,10,10
10,10,10,10,10,10,10,10,09,09,09,09,09,09,24,23,09,09,09,09,09,09,09,09,10,10,10,10,10,10,10,10
10,10,10,10,10,10,10,09,09,09,09,09,09,08,17,15,08,09,09,09,09,09,09,09,09,10,10,10,10,10,10,10
10,10,10,10,10,10,09,09,09,09,09,09,09,08,17,15,08,09,09,09,09,09,09,09,09,09,10,10,10,10,10,10
10,10,10,10,10,09,09,09,09,09,09,09,09,08,17,15,08,08,08,08,09,09,09,09,09,09,09,09,10,10,10,10
10,10,10,10,09,09,09,09,09,09,09,09,09,08,14,13,02,18,16,08,08,08,67,68,69,08,08,09,09,09,10,10
10,10,10,10,09,09,09,09,09,09,09,09,09,08,08,08,08,17,15,08,08,00,64,65,66,00,08,09,09,10,10,10
10,10,10,09,09,09,09,09,09,09,09,09,09,09,09,09,08,17,15,08,08,00,61,62,63,00,08,09,09,10,10,10
09,09,09,09,09,09,09,09,09,09,09,09,09,09,09,09,08,17,15,08,08,00,60,59,58,00,08,09,08,10,10,10
09,09,09,09,09,09,09,09,09,09,09,09,09,09,09,09,08,17,15,08,08,00,55,56,57,00,08,08,00,10,10,10
09,09,09,09,09,09,09,09,09,09,09,09,09,09,09,09,08,17,15,08,08,00,00,00,00,00,08,00,00,10,10,10
09,09,09,09,09,09,09,08,08,08,08,08,08,08,08,08,08,17,15,08,08,08,08,08,08,03,00,00,00,10,10,10
09,09,09,09,09,09,09,08,18,02,02,02,02,02,02,02,02,00,00,02,02,02,02,02,02,13,00,00,00,10,10,10
09,09,09,09,09,09,09,08,03,09,09,09,09,53,09,09,09,00,00,08,08,08,08,08,08,08,08,00,00,10,10,10
09,09,09,09,09,09,09,08,03,41,42,42,42,52,42,43,00,00,35,36,08,09,09,09,09,09,09,08,00,10,10,10
09,09,09,09,09,09,09,08,03,44,45,45,50,45,46,00,00,00,37,38,00,08,09,09,09,09,09,09,08,10,10,10
09,09,09,09,09,09,09,08,03,47,48,51,48,49,08,00,00,00,39,40,00,08,09,09,09,09,09,09,09,10,10,10
09,09,09,09,09,09,09,08,03,08,03,54,08,08,09,08,00,00,00,00,08,09,09,09,09,09,09,09,09,09,10,10
09,09,09,09,09,09,09,08,03,08,14,16,08,09,09,08,00,00,00,08,09,09,09,09,09,09,09,09,09,09,09,09
09,09,09,09,09,09,09,08,03,08,08,03,08,09,09,08,03,08,08,09,09,09,09,09,09,09,09,09,09,09,09,09
09,09,09,09,09,09,09,08,03,08,08,03,08,08,08,08,03,08,09,09,09,09,09,09,09,09,09,09,09,09,09,09
09,09,09,09,09,09,09,08,14,02,02,13,02,02,02,02,15,08,09,09,09,09,09,09,09,09,09,09,09,09,09,09
09,09,09,09,09,09,09,08,08,08,08,08,08,08,08,08,08,08,09,09,09,09,09,09,09,09,09,09,09,09,09,09
09,09,09,09,09,09,09,09,09,09,09,09,09,09,09,09,09,09,09,09,09,09,09,09,09,09,09,09,09,09,09,09
09,09,09,09,09,09,09,09,09,09,09,09,09,09,09,09,09,09,09,09,09,09,09,09,09,09,09,09,09,09,09,09
09,09,09,09,09,09,09,09,09,09,09,09,09,09,09,09,09,09,09,09,09,09,09,09,09,09,09,09,09,09,09,09
09,09,09,09,09,09,09,09,09,09,09,09,09,09,09,09,09,09,09,09,09,09,09,09,09,09,09,09,09,09,09,09
09,09,09,09,09,09,09,09,09,09,09,09,09,09,09,09,09,09,09,09,09,09,09,09,09,09,09,09,09,09,09,09
09,09,09,09,09,09,09,09,09,09,09,09,09,09,09,09,09,09,09,09,09,09,09,09,09,09,09,09,09,09,09,09

0,0,0,0,0,0,0,0,1,0,0,0,0,1,1,1,1,0,0,0,0,1,0,0,0,0,0,0,0,0,0,0
0,0,0,0,0,0,0,0,1,0,0,0,0,0,2,2,0,0,0,0,0,1,0,0,0,0,0,0,0,0,0,0
0,0,0,0,0,0,0,0,1,1,1,1,0,0,0,0,0,0,0,1,1,1,0,0,0,0,0,0,0,0,0,0
0,0,0,0,0,0,0,0,1,1,1,1,1,1,0,0,1,1,1,1,1,1,0,0,0,0,0,0,0,0,0,0
0,0,0,0,0,0,0,0,0,0,0,0,1,1,0,0,1,1,0,0,0,0,0,0,0,0,0,0,0,0,0,0
0,0,0,0,0,0,0,0,0,0,0,0,1,0,0,0,0,1,0,0,0,0,0,0,0,0,0,0,0,0,0,0
0,0,0,0,0,0,0,0,0,0,0,0,1,0,0,0,0,1,1,1,0,0,0,0,0,0,0,0,0,0,0,0
0,0,0,0,0,0,0,0,0,0,0,0,1,0,0,0,0,0,0,0,1,0,0,0,0,0,0,0,0,0,0,0
0,0,0,0,0,0,0,0,0,0,0,0,1,0,0,0,0,0,0,0,1,1,0,0,0,1,0,0,0,0,0,0
0,0,0,0,0,0,0,0,0,0,0,0,1,0,0,0,0,0,0,0,1,1,0,2,2,1,0,0,0,1,0,0
0,0,0,0,0,0,0,0,0,0,0,0,1,1,1,1,0,0,0,0,1,1,0,0,0,1,0,1,1,1,0,0
0,0,0,0,0,0,0,0,0,0,0,0,0,0,0,1,0,0,0,0,1,1,1,1,1,1,0,1,0,1,0,0
0,0,0,0,0,0,0,0,0,0,0,0,0,0,0,1,0,0,0,0,1,1,0,0,2,1,0,0,0,1,0,0
0,0,0,0,0,0,1,1,1,1,1,1,1,1,1,1,0,0,0,0,1,0,0,0,0,0,0,0,0,1,0,0
0,0,0,0,0,0,1,0,0,0,0,0,0,0,0,0,0,0,0,0,0,0,0,0,0,0,0,0,0,1,0,0
0,0,0,0,0,0,1,0,0,0,0,0,0,0,0,0,0,0,0,0,0,0,0,0,0,0,0,0,0,1,0,0
0,0,0,0,0,0,1,0,0,0,0,0,0,0,0,0,0,0,0,0,0,0,0,0,0,0,0,0,0,1,0,0
0,0,0,0,0,0,1,0,0,0,0,0,0,2,0,0,0,0,2,2,0,1,1,1,1,1,1,0,0,1,0,0
0,0,0,0,0,0,1,0,0,0,0,0,2,0,0,0,0,0,2,2,0,0,1,0,0,0,0,1,0,1,0,0
0,0,0,0,0,0,1,0,0,0,0,2,0,0,0,0,0,0,2,2,0,0,1,0,0,0,0,0,1,1,0,0
0,0,0,0,0,0,1,0,0,0,0,2,0,0,0,0,0,0,0,0,0,1,0,0,0,0,0,0,0,0,0,0
0,0,0,0,0,0,1,0,0,0,0,0,0,0,0,0,0,0,0,0,1,0,0,0,0,0,0,0,0,0,0,0
0,0,0,0,0,0,1,0,0,0,0,0,0,0,0,0,0,0,0,1,0,0,0,0,0,0,0,0,0,0,0,0
0,0,0,0,0,0,1,0,0,0,0,0,0,0,0,0,0,0,1,1,0,0,0,0,0,0,0,0,0,0,0,0
0,0,0,0,0,0,1,0,0,0,0,0,0,0,0,0,0,0,1,0,0,0,0,0,0,0,0,0,0,0,0,0
0,0,0,0,0,0,1,0,0,0,0,0,0,0,0,0,0,0,1,0,0,0,0,0,0,0,0,0,0,0,0,0
0,0,0,0,0,0,0,1,1,1,1,1,1,1,1,1,1,1,0,0,0,0,0,0,0,0,0,0,0,0,0,0
0,0,0,0,0,0,0,0,0,0,0,0,0,0,0,0,0,0,0,0,0,0,0,0,0,0,0,0,0,0,0,0
0,0,0,0,0,0,0,0,0,0,0,0,0,0,0,0,0,0,0,0,0,0,0,0,0,0,0,0,0,0,0,0
0,0,0,0,0,0,0,0,0,0,0,0,0,0,0,0,0,0,0,0,0,0,0,0,0,0,0,0,0,0,0,0
0,0,0,0,0,0,0,0,0,0,0,0,0,0,0,0,0,0,0,0,0,0,0,0,0,0,0,0,0,0,0,0
0,0,0,0,0,0,0,0,0,0,0,0,0,0,0,0,0,0,0,0,0,0,0,0,0,0,0,0,0,0,0,0